7
16
################
##A#...&....@..#
#....###.##.##0#
#0##.###$##.##.#
#.&..###.##....#
#B##........#X##
################
BONUS
1
3 8
CANALS
2 14
3 1
DIAMONDS
2
1 7
4 2
PLAYERS
1 12
1 2
5 1
5 13
KONEC